###############
#A   #      # #
# ### ##### # #
#   #     #   #
### # ### # ###
#   # #   #   #
# ### # ### ###
#     #   #   #
##### ### ### #
#   #   #     #
# # ### # ### #
# #     # Z # #
# ##### ### # #
#       #     #
###############